111111
1000N1
100101
100001
100001
111111