111111
100001
100001
100001
100001
101011