NO ./path_to_the_north_texture
SO ./path_to_the_south_texture
WE ./path_to_the_west_texture
EA ./path_to_the_east_texture
F 130,130,130
C 190,190,255

111111
100001
100101
100001
1N0001
111111